**********
*P   *   *
*        *
*        *
*        *
*        *
*        *
*        *
*       G*
**********